NO ./textures/north.xpm
EA ./textures/east.xpm
SO ./textures/south.xpm
WE ./textures/west.xpm
F 85,85,85
C 50,50,50

11111111
10000001
10011101
10011001
10011101 
10000001
100000N1
11111111
