NO ./res/Wall-000.xpm
EA ./res/Wall-003.xpm
SO ./res/Wall-002.xpm
WE ./res/Wall-001.xpm
F 85,85,85
C 50,50,50

11111111
10000001
10011101
10011001
100111011
10000001
100000N1
11111111
